1111111111111111
11          1  1
1 1        1 1 1
1  1      1   11
1   1    1     1
1    1  1      1
1     11       1
1111111111111111