1111111111111111
................
2222222222222222
3333333333333333
3333333333333333
2222222222222222
................
1111111111111111